11,7
2,0,0,0,0,0,0,0,0,0,2
0,0,-1,-1,0,0,0,0,0,0,0
0,0,0,-1,0,0,0,0,0,1,0
0,0,0,-1,0,0,0,0,0,0,0
0,0,0,0,0,0,0,0,0,0,0
0,0,0,0,0,0,0,0,0,1,0
2,0,0,0,0,0,0,0,0,0,2
Warp 2
1 4
2 3