11,7
2,0,0,0,0,0,0,0,0,0,2
0,0,-1,-1,0,0,0,0,0,0,0
0,0,0,-1,0,0,0,0,0,0,0
0,0,0,-1,0,0,0,0,0,0,0
0,0,0,0,0,0,0,0,0,0,0
0,0,0,0,0,0,0,0,0,0,0
2,0,0,0,0,0,0,0,0,0,2
Warp 2
1 4
2 3
Enemy 1
1,2 1,5 5,5 5,1